............
............
............
$..######..$
...######...
$..######..$
...######...
$..######..$
...######...
$..######..$
...######...
$..######..$