............
............
............
..########..
..########..
..########..
..########..
..########..
..########..
............
............
$$...$$...$$